#####
#A  #
# 11# ###
# 1 # #0#
### ###0#
a##    0#
a#   #  #
a#   ####
a#####*