a#######
a#     ###
##1###   #
# A 1  1 #
# 00# 1 ##
##00#   #
a########*