a####
##  #
#A1 #
##1 ##
## 1 #
#01  #
#0020#
######*